####################
# # ^ #Y  ###Ma ^^ #
# ^ M  ##M#######^##
#####M  #^     M#  #
#  ^   #MM M#M  ^^ #
#  ##^ #^  ^#####  #
#M  ^^#M #MY^ ^## M#
# ^# M#^ ###^   #^M#
# ^# ^M M### # M#  #
#  #Ma#  MYM # ^#M^#
# ^  Ma# ###^#M^#  #
#^###### ###^#^^^  #
#^## M ^  ^ ^ ###  #
#^## ^^##M#a# ##  ##
#^## ^#^^Y#######^^#
#^   ## ###M #   ^^#
# ###aM^ ^^^^  # ###
# ########### ^#  ##
#             ^#M aM
####################